%%%%%
%. .%
%%% %
%P% %
%. .%
%%%%%
