%%%%%%%
%.   .%
%  P  %
%%%%%%%
