%%%%%
%.. %
% %.%
%.%%%
%P  %
%%%%%
