%%%%%
%. .%
%   %
%   %
%.P.%
%%%%%
