%%%%%%%%%%%%%%%%%%%%%%%%
%.    P .       ..     %
%%%%%%%%%%%%%%%%%%%%%%%%
