%%%%%
%.  %
%   %
%.P %
%   %
%   %
%.  %
%%%%%
