%%%%%
% . %
%   %
% P %
%   %
%   %
% . %
%%%%%
