%%%%%
% . %
% P %
%   %
%   %
%   %
%   %
%%%%%
